a=あ
i=い
u=う
e=え
o=お
ka=か
ki=き
ku=く
ke=け
ko=こ
kz=かん
kk=きん
kj=くん
kd=けん
kl=こん
sa=さ
si=し
su=す
se=せ
so=そ
sz=さん
sk=しん
sj=すん
sd=せん
sl=そん
ta=た
ti=ち
tu=つ
te=て
to=と
tz=たん
tk=ちん
tj=つん
td=てん
tl=とん
na=な
ni=に
nu=ぬ
ne=ね
no=の
nz=なん
nk=にん
nj=ぬん
nd=ねん
nl=のん
ha=は
hi=ひ
hu=ふ
he=へ
ho=ほ
hz=はん
hk=ひん
hj=ふん
hd=へん
hl=ほん
ma=ま
mi=み
mu=む
me=め
mo=も
mz=まん
mk=みん
mj=むん
md=めん
ml=もん
ya=や
yu=ゆ
yo=よ
yz=やん
yj=ゆん
yl=よん
ra=ら
ri=り
ru=る
re=れ
ro=ろ
rz=らん
rk=りん
rj=るん
rd=れん
rl=ろん
wa=わ
wo=を
wz=わん
wk=うぃん
wd=うぇん
wl=うぉん
ga=が
gi=ぎ
gu=ぐ
ge=げ
go=ご
gz=がん
gk=ぎん
gj=ぐん
gd=げん
gl=ごん
za=ざ
zi=じ
zu=ず
ze=ぜ
zo=ぞ
zz=ざん
zk=じん
zj=ずん
zd=ぜん
zl=ぞん
da=だ
di=ぢ
du=づ
de=で
do=ど
dz=だん
dk=ぢん
dj=づん
dd=でん
dl=どん
dci=でぃ
dd=でん
dy=でゅ
dcy=でゅ
ba=ば
bi=び
bu=ぶ
be=べ
bo=ぼ
bz=ばん
bk=びん
bj=ぶん
bd=べん
bl=ぼん
pa=ぱ
pi=ぴ
pu=ぷ
pe=ぺ
po=ぽ
pz=ぱん
pk=ぴん
pj=ぷん
pd=ぺん
pl=ぽん
kya=きゃ
kyu=きゅ
kye=きぇ
kyo=きょ
sya=しゃ
syu=しゅ
sye=しぇ
syo=しょ
xa=しゃ
xi=し
xu=しゅ
xe=しぇ
xo=しょ
tya=ちゃ
tyu=ちゅ
tye=ちぇ
tyo=ちょ
ca=ちゃ
ci=ち
cu=ちゅ
ce=ちぇ
co=ちょ
nya=にゃ
nyu=にゅ
nye=にぇ
nyo=にょ
hya=ひゃ
hyu=ひゅ
hye=ひぇ
hyo=ひょ
mya=みゃ
myu=みゅ
mye=みぇ
myo=みょ
rya=りゃ
ryu=りゅ
rye=りぇ
ryo=りょ
kyz=きゃん
kyj=きゅん
kyd=きぇん
kyl=きょん
kgz=きゃん
kgj=きゅん
kgd=きぇん
kgl=きょん
xz=しゃん
xj=しゅん
xd=しぇん
xl=しょん
cz=ちゃん
cj=ちゅん
cd=ちぇん
cl=ちょん
ngz=にゃん
ngj=にゅん
ngd=にぇん
ngl=にょん
hyz=ひゃん
hyj=ひゅん
hyd=ひぇん
hyl=ひょん
myz=みゃん
myj=みゅん
myd=みぇん
myl=みょん
ryz=りゃん
ryj=りゅん
ryd=りぇん
ryl=りょん
gya=ぎゃ
gyu=ぎゅ
gye=ぎぇ
gyo=ぎょ
zya=じゃ
zyu=じゅ
zye=じぇ
zyo=じょ
bya=びゃ
byu=びゅ
bye=びぇ
byo=びょ
pya=ぴゃ
pyu=ぴゅ
pye=ぴぇ
pyo=ぴょ
gyz=ぎゃん
gyj=ぎゅん
gyd=ぎぇん
gyl=ぎょん
zyz=じゃん
zyj=じゅん
zyd=じぇん
zyl=じょん
jz=じゃん
jj=じゅん
jd=じぇん
jl=じょん
byz=びゃん
byj=びゅん
byd=びぇん
byl=びょん
pyz=ぴゃん
pyj=ぴゅん
pyd=ぴぇん
pyl=ぴょん
pgz=ぴゃん
pgj=ぴゅん
pgd=ぴぇん
pgl=ぴょん
xa=しゃ
xu=しゅ
xe=しぇ
xo=しょ
ja=じゃ
ji=じ
ju=じゅ
je=じぇ
jo=じょ
tgi=てぃ
tgu=とぅ
dci=でぃ
dcu=どぅ
fa=ふぁ
fi=ふぃ
fu=ふ
fe=ふぇ
fo=ふぉ
va=ヴぁ
vi=ヴぃ
vu=ヴ
ve=ヴぇ
vo=ヴぉ
wso=うぉ
q=ん
nn=ん
la=ぁ
li=ぃ
lu=ぅ
le=ぇ
lo=ぉ
lya=ゃ
lyu=ゅ
lyo=ょ
lga=ゃ
lgu=ゅ
lgo=ょ
ltu=っ
lka=ヵ
lke=ヶ
lwa=ゎ
;=っ
:=ー
-=ー
,=、
.=。
/=・
[=「
]=」
z/=・
z,=‥
z.=…
z[=『
z]=』
z:=〜
z-=〜
